   WE                            src/assets/textures/wolfenstein/grey_stone.xpm
NO      src/assets/textures/wolfenstein/purple_stone.xpm



SO src/assets/textures/wolfenstein/red_brick.xpm

F      17,    38,     64

EA src/assets/textures/wolfenstein/wood.xpm



C 255, 0, 0

1111111111111111111111111
10N0110000100000000000001
1000110000000000111111001
1000110000000000110001001
1000000000100000000001001
1111111111111111111111111
